10 17
main
.................
.................
.................
.................
......B#.........
.B...###.........
.B...#...........
.P.B.............
GGGGGGGGGGGGGGGGG
GGGGGGGGGGGGGGGGG
shadow
.................
.................
..####...........
.................
.................
.................
.................
.................
.................
.................